00000000000000001111111111111113
00000000000001111111111111111113
00000000000011111111111111111113
00000000000111111111111111111113
00000000000111111111111111111113
00000000000111111111111111111113
00000000000111111111111111111113
00000000000011111111111111111113
00000000000001111111111111111113
00000000000000111111111111111100
00000000000000111111111111100000
00000000000000111111111111000000
00000000000000111111111100000000
00000000000000111111111000000000
00000000000001111111111000000000
00000000000011111111111000000000
00000000000111111111111000000000
00000000001111111111111000000000
00000000011111111111111000000000
00000000111111111111111000000000
00000001111111111111111000000000
00000011111111111111111000000000
00000111111111111111111000000000
00001111111111111111111000000000
00011111111111111111111000000000
00111111111111111111111000000000
01111111111111111111111000000000
11111111111111111111111000000000
11111111111111111111111000000000
22222222222222222222222000000000