00011111111111113
00111111111111113
00111111111111113
01111111111111113
11111111111111113
11111111111111113
11111111110000000
11111111100000000
11111111100000000
11111111100000000
11111111100000000
11111111100000000
11111111100000000
11111111100000000
01111111100000000
01111111100000000
01111111100000000
01111111100000000
01111111100000000
01111111100000000
01111111100000000
01111111100000000
00111111100000000
00111111100000000
00111111100000000
00111111100000000
00111111100000000
00111111100000000
00111111100000000
00011111100000000
00011111100000000
00022222200000000